#domain
hospital
#levelname
BFSFriendly
#colors
blue: 0,1
#initial
+++++++++++++++++++++++++++++
+     0                     +
+++         1               +
++                          +
+                           +
+                       +++++
+                           +
+++++++++++++++++++++++++++++
#goal
+++++++++++++++++++++++++++++
+   0      1                +
+++                         +
++                          +
+                           +
+                       +++++
+                           +
+++++++++++++++++++++++++++++
#end
